https://ic3review.iigvietnam.edu.vn/k5gs6.html

24161219
24161220
24161221
24161222
24161223
24161224
24161225
24161226
24161227
24161228
24161229
